...........###########
##########.###########
##########.###########
#....................#
##########.###########
##########.###########
##########............
\robot 0 6
\robot 1 6
\robot 2 6
