#...................#..................#
.#................#..#................#.
..#..............#....#..............#..
...#............#......#............#...
....#..........#........#..........#....
.....#........#..........#........#.....
......#......#............#......#......
.......#....#..............#....#.......
........#..#................#..#........
..........#...................#.........
\robot 0 8
