######################
##########.###########
#....................#
######################
######################
\robot 1 2
\robot 2 2
\robot 3 2
\robot 4 2
